District Name,result_totpop_totpop,result_eng_illiterate,result_ent_internet,result_df_illit_inte,result_ill_noint_illit_no_inte,result_lit_noint_ lit_no_inte,result_lit_ int_lit_inte,result_illit_eng_literate_local_illit_eng_literate_local,result_literate_local_use_int_literate_local_used_int,result_literate_local_not_int_literate_local_not_used_int,prop_English_ Illiterate,prop_Did_Not_Used_ Internet,prop_Illiterate_ Internet,prop_Illiterate_NoInternet,prop_Literate_Nointernet,prop_Literate_ Internet,prop_Illit_Eng_Literate_Local,prop_lit_local_Usedict,prop_lit_local_Not_Usedict
Jomoro Municipal,10645,4047,3671,1210,2837,834,5764,393,3438,419,0.380178488,0.34485674,0.113668389,0.266510099,0.078346642,0.541474871,0.036918741,0.32296853,0.039361202
Ellembelle,10261,3532,3276,1096,2436,840,5889,357,3500,460,0.344215963,0.319267128,0.106812202,0.237403762,0.081863366,0.57392067,0.034791931,0.341097359,0.044829939
Nzema East Municipal,7989,3487,3369,763,2724,645,3857,135,1639,231,0.436475153,0.421704844,0.095506321,0.340968832,0.080736012,0.482788835,0.016898235,0.205157091,0.028914758
Ahanta West Municipal,13119,4118,4195,985,3133,1062,7939,226,3390,352,0.313895876,0.319765226,0.075081942,0.238813934,0.080951292,0.605152832,0.017226923,0.258403842,0.026831313
Effia Kwesimintsim Municipal,15267,1798,1728,786,1012,716,12753,239,6836,277,0.117770354,0.113185302,0.051483592,0.066286762,0.046898539,0.835331106,0.01565468,0.447763149,0.018143709
Sekondi Takoradi Metropolitan Area (STMA),21463,2690,2788,984,1706,1082,17691,301,10534,516,0.125331967,0.129897964,0.04584634,0.079485626,0.050412338,0.824255696,0.014024135,0.490798118,0.024041374
Shama,10025,2665,2830,688,1977,853,6507,265,4400,546,0.265835411,0.282294264,0.068628429,0.197206983,0.085087282,0.649077307,0.026433915,0.438902743,0.05446384
Wassa East,8437,3452,3338,802,2650,688,4297,254,2002,278,0.409150172,0.39563826,0.095057485,0.314092687,0.081545573,0.509304255,0.030105488,0.237288136,0.032950101
Mpohor,4497,1517,1551,337,1180,371,2609,149,1306,184,0.337336002,0.344896598,0.074938848,0.262397154,0.082499444,0.580164554,0.0331332,0.290415833,0.040916166
Tarkwa-Nsuaem Municipal,18840,4220,3754,1489,2731,1023,13597,408,6515,416,0.223991507,0.1992569,0.07903397,0.144957537,0.054299363,0.72170913,0.021656051,0.345806794,0.022080679
Prestea/Huni Valley Municipal,19408,6409,5882,1827,4582,1300,11699,579,4430,422,0.33022465,0.303070899,0.094136439,0.236088211,0.066982688,0.602792663,0.029833059,0.228256389,0.021743611
Wassa Amenfi East Municipal,15320,6189,5745,1342,4847,898,8233,337,3887,431,0.403981723,0.375,0.087597911,0.316383812,0.058616188,0.537402089,0.021997389,0.253720627,0.028133159
Wassa Amenfi Central,9929,4288,3770,1099,3189,581,5060,226,2573,277,0.43186625,0.37969584,0.11068587,0.321180381,0.05851546,0.50961829,0.022761607,0.259139893,0.027898076
Wassa Amenfi West Municipal,11135,4188,3858,1111,3077,781,6166,274,3077,323,0.376111361,0.346475079,0.099775483,0.276335878,0.070139201,0.553749439,0.024607095,0.276335878,0.029007634
Komenda Edina Eguafo Abirem Municipal,14200,4598,4730,1055,3543,1187,8415,330,5286,694,0.323802817,0.333098592,0.074295775,0.249507042,0.083591549,0.592605634,0.023239437,0.372253521,0.048873239
Cape Coast Metropolitan Area (CCMA),16855,2271,2666,684,1587,1079,13505,267,9574,654,0.134737467,0.158172649,0.04058143,0.094156037,0.064016612,0.801245921,0.015840997,0.568021359,0.038801543
Abura Asebu Kwamankese,10707,3678,3765,877,2801,964,6065,383,4443,735,0.343513589,0.351639115,0.081909031,0.261604558,0.090034557,0.566451854,0.035770991,0.414962174,0.06864668
Mfantsiman Municipal,14554,4427,4537,1229,3198,1339,8788,533,6024,957,0.304177546,0.311735605,0.084444139,0.219733407,0.092002199,0.603820256,0.036622234,0.41390683,0.065755119
Ekumfi,4870,1992,2113,372,1620,493,2385,156,1712,362,0.409034908,0.433880903,0.076386037,0.332648871,0.101232033,0.48973306,0.032032854,0.351540041,0.074332649
Gomoa West,11019,4329,4357,900,3429,928,5762,356,3603,549,0.392866866,0.395407932,0.081677103,0.311189763,0.084218169,0.522914965,0.032307832,0.32698067,0.049823033
Effutu Municipal,9724,2086,2337,386,1700,637,7001,111,4574,287,0.214520773,0.240333196,0.039695599,0.174825175,0.065508021,0.719971205,0.011415056,0.470382559,0.029514603
Gomoa Central,7066,1987,2019,490,1497,522,4557,242,2994,373,0.281205774,0.285734503,0.069346165,0.211859609,0.073874894,0.644919332,0.034248514,0.423719219,0.052787999
Gomoa East,26207,4929,4660,1974,2955,1705,19573,615,8473,603,0.188079521,0.177815088,0.075323387,0.112756134,0.065058954,0.746861526,0.023467013,0.323310566,0.02300912
Awutu Senya East Municipal,20496,2936,2870,1352,1584,1286,16274,454,6721,384,0.143247463,0.140027322,0.065964091,0.077283372,0.06274395,0.794008587,0.022150664,0.327917642,0.018735363
Awutu Senya,13525,4254,4429,1001,3253,1176,8095,220,3369,349,0.314528651,0.327467652,0.074011091,0.24051756,0.086950092,0.598521257,0.016266174,0.24909427,0.025804067
Agona East,8517,2535,2678,600,1935,743,5239,237,3060,417,0.297640014,0.314429964,0.070447341,0.227192673,0.08723729,0.615122696,0.0278267,0.359281437,0.048960902
Agona West Municipal,11829,3057,3152,792,2265,887,7885,327,4505,477,0.258432665,0.266463775,0.066954096,0.19147857,0.074985206,0.666582129,0.027643926,0.380843689,0.040324626
Asikuma Odoben Brakwa,10896,3775,3780,822,2953,827,6294,445,4017,530,0.346457416,0.3469163,0.075440529,0.271016887,0.075899413,0.577643172,0.040840675,0.368667401,0.048641703
Ajumako Enyan Essiam,10220,3225,3313,734,2491,822,6173,318,4167,565,0.31555773,0.324168297,0.071819961,0.243737769,0.080430528,0.604011742,0.03111546,0.407729941,0.055283757
Assin South,8961,2966,3099,612,2354,745,5250,203,3169,417,0.330989845,0.345831938,0.068295949,0.262693896,0.083138043,0.585872112,0.022653722,0.353643567,0.046534985
Twifo Heman Lower Denkyira,5650,1794,1892,499,1295,597,3259,148,1909,322,0.317522124,0.334867257,0.088318584,0.22920354,0.105663717,0.576814159,0.02619469,0.337876106,0.05699115
Twifo Ati Morkwa,8564,3067,3063,811,2256,807,4690,313,2635,415,0.358127043,0.357659972,0.094698739,0.263428305,0.094231667,0.547641289,0.036548342,0.307683326,0.048458664
Assin Fosu Municipal,7658,1579,1667,540,1039,628,5451,241,3644,357,0.206189606,0.217680857,0.070514495,0.135675111,0.082005746,0.711804649,0.031470358,0.475842256,0.046617916
Assin North,6865,2405,2441,592,1813,628,3832,235,2136,313,0.350327749,0.355571741,0.086234523,0.264093227,0.091478514,0.558193736,0.03423161,0.311143481,0.045593591
Upper Denkyira East Municipal,9329,2620,2359,856,1764,595,6114,329,3885,343,0.280844678,0.252867403,0.091756887,0.189087791,0.063779612,0.65537571,0.035266374,0.416443349,0.03676707
Upper Denkyira West,7629,3007,2410,1003,2004,406,4216,308,2612,256,0.394153886,0.315899856,0.131472015,0.262681872,0.053217984,0.55262813,0.040372264,0.342377769,0.033556167
Ga South Municipal,29986,5682,5750,2138,3544,2206,22098,714,9790,513,0.189488428,0.191756153,0.07129994,0.118188488,0.073567665,0.736943907,0.023811112,0.326485693,0.017107984
Weija Gbawe Municipal,18595,2200,2186,1114,1086,1100,15295,470,7351,266,0.118311374,0.117558483,0.059908578,0.058402796,0.059155687,0.822532939,0.025275612,0.395321323,0.014304921
Ga Central Municipal,28899,3260,2953,1848,1412,1541,24098,878,12008,467,0.112806672,0.102183467,0.063946849,0.048859822,0.053323644,0.833869684,0.030381674,0.415516108,0.016159729
Ablekuma North Municipal,14090,1462,1432,720,742,690,11938,305,5508,193,0.103761533,0.101632363,0.051100071,0.052661462,0.048970901,0.847267566,0.021646558,0.390915543,0.013697658
Ablekuma West Municipal,13495,1428,1517,630,798,719,11348,238,5285,188,0.105816969,0.112412004,0.046683957,0.059133012,0.053278992,0.840904039,0.017636162,0.391626528,0.013931086
Ablekuma Central Municipal,14934,2410,1897,1218,1192,705,11819,386,5387,218,0.161376724,0.127025579,0.081558859,0.079817865,0.047207714,0.791415562,0.02584706,0.360720504,0.014597563
Accra Metropolitan Area (AMA),25182,4958,4156,1835,3123,1033,19191,327,8332,267,0.196886665,0.16503852,0.07286951,0.124017155,0.041021364,0.76209197,0.012985466,0.330871257,0.010602812
Korle Klottey Municipal,5974,805,616,387,418,198,4971,164,2464,59,0.134750586,0.103113492,0.064780716,0.069969869,0.033143622,0.832105792,0.027452293,0.412453967,0.00987613
Ayawaso Central Municipal,8476,1072,977,499,573,404,7000,154,2792,83,0.126474752,0.115266635,0.058872109,0.067602643,0.047663992,0.825861255,0.018168948,0.329400661,0.009792355
Ayawaso East Municipal,4680,1091,845,511,580,265,3324,59,1160,54,0.233119658,0.180555556,0.109188034,0.123931624,0.056623932,0.71025641,0.012606838,0.247863248,0.011538462
Ayawaso North Municipal,5626,981,739,514,467,272,4373,71,1420,55,0.174369001,0.131354426,0.091361536,0.083007465,0.048346961,0.777284038,0.012619979,0.252399573,0.00977604
La Dade-Kotopon Municipal,12450,995,965,487,508,457,10998,215,6449,189,0.079919679,0.07751004,0.039116466,0.040803213,0.036706827,0.883373494,0.017269076,0.517991968,0.015180723
Ledzokuku Municipal,19274,2181,2101,995,1186,915,16178,340,8655,325,0.113157622,0.109006952,0.051623949,0.061533672,0.04747328,0.839369098,0.017640345,0.449050534,0.016862094
Krowor Municipal,12670,1298,1175,668,630,545,10827,264,5555,182,0.102446725,0.092738753,0.052722968,0.049723757,0.043014996,0.854538279,0.020836622,0.438437253,0.014364641
Adentan Municipal,23317,2387,2179,1318,1069,1110,19820,505,9953,309,0.10237166,0.09345113,0.056525282,0.045846378,0.047604752,0.850023588,0.021658018,0.426855942,0.013252134
Ayawaso West Municipal,6880,598,543,285,313,230,6052,118,3414,50,0.086918605,0.078924419,0.041424419,0.045494186,0.033430233,0.879651163,0.017151163,0.49622093,0.007267442
Okaikoi North Municipal,14342,1636,1318,901,735,583,12123,326,5633,146,0.114070562,0.091897922,0.062822479,0.051248083,0.04064984,0.845279598,0.022730442,0.392762516,0.010179891
Ga North Municipal,20648,2307,1986,1275,1032,954,17387,412,7703,229,0.11172995,0.09618365,0.061749322,0.049980628,0.046203022,0.842067028,0.019953506,0.373062766,0.011090663
Ga West Municipal,26946,4214,3871,2069,2145,1726,21006,678,9195,500,0.156386848,0.143657686,0.076783196,0.079603652,0.064054034,0.779559118,0.025161434,0.341238032,0.01855563
Ga East Municipal,24900,2422,2094,1362,1060,1034,21444,579,11168,326,0.097269076,0.084096386,0.054698795,0.042570281,0.041526104,0.861204819,0.023253012,0.448514056,0.013092369
La Nkwantanang Madina Municipal,19432,2032,2000,1026,1006,994,16406,404,7969,238,0.104569782,0.102923014,0.052799506,0.051770276,0.051152738,0.84427748,0.020790449,0.410096748,0.012247839
Kpone Katamanso Municipal,35300,4600,4720,2200,2400,2320,28380,808,11428,579,0.130311615,0.133711048,0.062322946,0.067988669,0.06572238,0.803966006,0.022889518,0.323739377,0.016402266
Ashaiman Municipal,18062,2668,2773,1066,1602,1171,14223,332,5475,266,0.147713432,0.153526741,0.059018935,0.088694497,0.064832244,0.787454324,0.018381132,0.303122578,0.014727051
Tema West Municipal,17260,1389,1400,724,665,735,15136,275,7370,164,0.080475087,0.081112399,0.041946698,0.038528389,0.042584009,0.876940904,0.015932793,0.426998841,0.009501738
Tema Metropolitan Area (TMA),15704,2229,2173,836,1393,780,12695,285,5536,216,0.14193836,0.138372389,0.053234845,0.088703515,0.049668874,0.808392766,0.018148242,0.352521651,0.013754457
Ningo-Prampram,17520,3874,4152,1093,2781,1371,12275,290,6046,336,0.221118721,0.236986301,0.062385845,0.158732877,0.078253425,0.700627854,0.016552511,0.345091324,0.019178082
Shai-Osudoku,9016,2450,2513,672,1778,735,5831,165,2256,190,0.27173913,0.278726708,0.074534161,0.197204969,0.081521739,0.64673913,0.018300799,0.250221828,0.021073647
Ada West,6256,2627,2791,475,2152,639,2990,142,2136,427,0.41991688,0.446131714,0.07592711,0.34398977,0.102141944,0.477941176,0.02269821,0.341432225,0.068254476
Ada East,6484,2240,2567,371,1869,698,3546,68,2274,406,0.345465762,0.395897594,0.057217767,0.288247995,0.107649599,0.546884639,0.010487353,0.350709439,0.062615669
South Tongu,9748,3642,3779,771,2871,908,5198,434,4185,753,0.373615101,0.387669265,0.079093147,0.294521953,0.093147312,0.533237587,0.044521953,0.429318835,0.077246615
Anloga,8259,3510,3380,821,2689,691,4058,517,3748,643,0.424990919,0.409250515,0.099406708,0.325584211,0.083666303,0.491342778,0.062598378,0.453807967,0.077854462
Keta Municipal,6901,2286,2423,564,1722,701,3914,326,3471,621,0.33125634,0.351108535,0.081727286,0.249529054,0.101579481,0.567164179,0.047239531,0.502970584,0.089986958
Ketu South Municipal,21414,9353,8076,3006,6347,1729,10332,1854,9576,1494,0.436770337,0.377136453,0.140375455,0.296394882,0.080741571,0.482488092,0.086578874,0.447184085,0.069767442
Ketu North Municipal,9885,4233,4099,926,3307,792,4860,593,4423,713,0.428224583,0.41466869,0.093677289,0.334547294,0.080121396,0.491654021,0.059989884,0.447445625,0.072129489
Akatsi North,2785,1339,1285,278,1061,224,1222,200,1133,216,0.480789946,0.461400359,0.099820467,0.380969479,0.08043088,0.438779174,0.071813285,0.406822262,0.077558348
Akatsi South Municipal,7938,3187,3127,730,2457,670,4081,470,3638,649,0.401486521,0.393927942,0.091962711,0.30952381,0.084404132,0.514109347,0.059208869,0.458301839,0.081758629
Central Tongu,7197,3283,3222,697,2586,636,3278,349,2623,503,0.45616229,0.447686536,0.096845908,0.359316382,0.088370154,0.455467556,0.048492427,0.364457413,0.069890232
North Tongu,9460,3929,4017,809,3120,897,4634,453,3477,665,0.415327696,0.424630021,0.08551797,0.329809725,0.094820296,0.489852008,0.047885835,0.367547569,0.070295983
Ho West,7276,2178,2022,769,1409,613,4485,600,3900,468,0.299340297,0.277899945,0.10568994,0.193650357,0.084249588,0.616410115,0.082462892,0.536008796,0.064321056
Adaklu,3317,1362,1343,364,998,345,1610,268,1338,290,0.410611999,0.404883931,0.109737715,0.300874284,0.104009647,0.485378354,0.0807959,0.403376545,0.087428399
Agortime-Ziope,3469,1416,1381,354,1062,319,1734,237,1614,285,0.408186797,0.398097434,0.102046699,0.306140098,0.091957336,0.499855866,0.0683194,0.465263765,0.082156241
Ho Municipal,15934,2786,2402,1342,1444,958,12190,911,10419,756,0.174846241,0.150746831,0.084222417,0.090623823,0.060123007,0.765030752,0.05717334,0.653884775,0.047445714
South Dayi,5020,1537,1441,523,1014,427,3056,316,2409,256,0.306175299,0.287051793,0.104183267,0.201992032,0.085059761,0.60876494,0.062948207,0.479880478,0.050996016
Afadzato South,6265,1956,1802,731,1225,577,3732,553,3296,417,0.312210694,0.287629689,0.116679968,0.195530726,0.092098962,0.595690343,0.088268156,0.526097366,0.066560255
North Dayi,3481,1047,937,399,648,289,2145,322,1920,239,0.300775639,0.269175524,0.114622235,0.186153404,0.08302212,0.616202241,0.092502155,0.551565642,0.068658431
Kpando Municipal,5107,1344,1250,440,904,346,3417,283,2684,251,0.263168201,0.244762091,0.086156256,0.177011944,0.067750147,0.669081653,0.055414137,0.525553162,0.049148228
Hohoe Municipal,9927,2632,2178,1164,1468,710,6585,773,5280,442,0.265135489,0.219401632,0.117255969,0.14787952,0.071522111,0.6633424,0.07786844,0.531882744,0.044525033
Birim South,3066,824,880,202,622,258,1984,82,1348,159,0.268754077,0.287018917,0.065883888,0.202870189,0.084148728,0.647097195,0.026744945,0.439660796,0.0518591
Birim Central Municipal,6618,1217,1214,494,723,491,4910,212,3417,308,0.183892415,0.183439105,0.074644908,0.109247507,0.074191599,0.741915987,0.032033847,0.51631913,0.04653974
Achiase,4837,1661,1719,410,1251,468,2708,202,1991,350,0.343394666,0.35538557,0.084763283,0.258631383,0.096754186,0.559851147,0.041761422,0.411618772,0.0723589
Asene Manso Akroso,6648,2022,2184,445,1577,607,4019,200,2595,380,0.304151625,0.328519856,0.066937425,0.2372142,0.091305656,0.60454272,0.030084236,0.39034296,0.057160048
West Akim Municipal,10267,2985,3122,744,2241,881,6401,237,3923,516,0.290737314,0.304081036,0.07246518,0.218272134,0.085808902,0.623453784,0.023083666,0.382097984,0.050258109
Upper West Akim,8154,2906,3056,612,2294,762,4486,207,2477,372,0.356389502,0.374785381,0.075055188,0.281334314,0.093451067,0.550159431,0.025386313,0.303777287,0.045621781
Ayensuano,8020,2830,2802,715,2115,687,4503,271,2598,346,0.35286783,0.349376559,0.08915212,0.263715711,0.085660848,0.561471322,0.033790524,0.32394015,0.043142145
Nsawam Adoagyiri Municipal,13394,2820,2735,987,1833,902,9672,380,5619,444,0.210542034,0.204195909,0.073689712,0.136852322,0.067343587,0.72211438,0.028370912,0.419516201,0.033149171
Akwapim South Municipal,6699,1318,1389,398,920,469,4912,161,3256,263,0.196745783,0.20734438,0.059411853,0.13733393,0.070010449,0.733243768,0.024033438,0.486042693,0.039259591
Akwapim North Municipal,9261,1870,1993,560,1310,683,6708,284,5076,457,0.201922039,0.215203542,0.060468632,0.141453407,0.073750135,0.724327826,0.030666235,0.548104956,0.049346723
Okere,4474,1332,1418,326,1006,412,2730,210,1925,277,0.297720161,0.316942333,0.072865445,0.224854716,0.092087617,0.610192222,0.046937863,0.430263746,0.061913277
New Juaben South Municipal,11555,1549,1484,662,887,597,9409,332,6509,323,0.134054522,0.128429251,0.057291216,0.076763306,0.051665945,0.814279533,0.028732151,0.563305928,0.027953267
New Juaben North Municipal,7836,1016,1098,422,594,504,6316,169,4498,302,0.129657989,0.140122511,0.053854007,0.075803982,0.06431853,0.806023481,0.021567126,0.574017356,0.038540071
Suhum Municipal,10904,2674,2671,850,1824,847,7383,320,4848,551,0.245231108,0.244955979,0.077953045,0.167278063,0.077677916,0.677090976,0.029347029,0.444607483,0.050531915
Abuakwa North Municipal,6649,1307,1342,439,868,474,4868,185,3357,301,0.196570913,0.201834862,0.066024966,0.130545947,0.071288916,0.732140171,0.027823733,0.504887953,0.045269965
Abuakwa South Municipal,7765,1997,1951,587,1410,541,5227,273,3765,331,0.257179652,0.251255634,0.075595621,0.181584031,0.069671603,0.673148744,0.035157759,0.484867997,0.042627173
Denkyembuor,6711,1861,1785,582,1279,506,4344,207,2854,278,0.277305916,0.265981225,0.08672329,0.190582626,0.075398599,0.647295485,0.030844882,0.425271942,0.041424527
Akyemansa,7797,2927,3000,695,2232,768,4102,329,2560,482,0.375400795,0.384763371,0.089136848,0.286263948,0.098499423,0.526099782,0.042195716,0.32833141,0.061818648
Kwaebibirem Municipal,10519,2897,2868,934,1963,905,6717,441,4610,570,0.275406407,0.272649491,0.08879171,0.186614697,0.086034794,0.638558798,0.041924137,0.438254587,0.05418766
Birim North,7078,2051,2015,619,1432,583,4444,248,2871,389,0.289771122,0.284684939,0.087454083,0.202317039,0.082367901,0.627860978,0.035038146,0.405623057,0.054959028
Atiwa West,5214,1508,1340,517,991,349,3357,263,2345,211,0.289221327,0.257000384,0.099156118,0.190065209,0.066935175,0.643843498,0.05044112,0.449750671,0.040467971
Atiwa East,5448,1510,1418,502,1008,410,3528,256,2277,235,0.277165932,0.260279001,0.092143906,0.185022026,0.075256975,0.647577093,0.046989721,0.417951542,0.043135095
Fanteakwa South,4685,1145,1181,344,801,380,3160,156,2216,230,0.244397012,0.25208111,0.073425827,0.170971185,0.081109925,0.674493063,0.033297759,0.472998933,0.04909285
Yilo Krobo Municipal,10682,2766,3042,623,2143,899,7017,231,3434,357,0.258940273,0.284778131,0.058322412,0.200617862,0.08416027,0.656899457,0.021625164,0.321475379,0.033420708
Lower Manya Krobo Municipal,10805,2620,2532,810,1810,722,7463,208,3632,265,0.242480333,0.234335956,0.074965294,0.167515039,0.066820916,0.690698751,0.019250347,0.336140676,0.024525683
Asuogyaman,8858,2071,2315,567,1504,811,5976,235,3307,282,0.233799955,0.261345676,0.064009935,0.16979002,0.091555656,0.674644389,0.026529691,0.373334839,0.031835629
Upper Manya Krobo,6036,2710,2789,413,2297,492,2834,198,1635,279,0.44897283,0.462060968,0.068422797,0.380550033,0.081510934,0.469516236,0.032803181,0.270874751,0.046222664
Fanteakwa North,4869,1779,1748,435,1344,404,2686,153,1642,213,0.365372766,0.359005956,0.089340727,0.276032039,0.082973917,0.551653317,0.03142329,0.337235572,0.043746149
Kwahu South Municipal,6822,2215,2173,598,1617,556,4051,321,3066,387,0.324684843,0.318528291,0.087657578,0.237027265,0.081501026,0.593814131,0.04705365,0.44942832,0.056728232
Kwahu West Municipal,12420,2839,2773,963,1876,897,8684,448,6289,618,0.228582931,0.223268921,0.077536232,0.151046699,0.072222222,0.699194847,0.036070853,0.506360709,0.049758454
Kwahu East,6931,2335,2282,694,1641,641,3955,398,3169,453,0.336892223,0.329245419,0.100129851,0.236762372,0.092483047,0.570624729,0.057423171,0.45722118,0.065358534
Kwahu Afram Plains South,6136,3221,3148,564,2657,491,2424,174,1450,254,0.524934811,0.51303781,0.091916558,0.433018253,0.080019557,0.395045632,0.028357236,0.2363103,0.041395046
Kwahu Afram Plains North,5543,3092,2821,605,2487,334,2117,206,1316,161,0.557820675,0.508930182,0.109146671,0.448674003,0.060256179,0.381923146,0.037163991,0.237416561,0.029045643
Amansie South,9590,3771,2989,1255,2516,473,5346,416,3177,313,0.393222106,0.311678832,0.130865485,0.262356621,0.049322211,0.557455683,0.043378519,0.331282586,0.032638165
Amansie Central,8004,3233,2835,894,2339,496,4275,463,3053,402,0.403923038,0.354197901,0.111694153,0.292228886,0.061969015,0.534107946,0.057846077,0.381434283,0.050224888
Akrofuom,4175,1750,1475,559,1191,284,2141,226,1405,202,0.419161677,0.353293413,0.133892216,0.285269461,0.068023952,0.512814371,0.054131737,0.336526946,0.048383234
Adansi South,7317,2581,2529,697,1884,645,4091,287,2697,486,0.352740194,0.345633456,0.095257619,0.257482575,0.088150882,0.559108924,0.039223726,0.368593686,0.066420664
Adansi Asokwa,6132,2240,2084,680,1560,524,3368,264,2141,363,0.365296804,0.339856491,0.110893673,0.254403131,0.085453359,0.549249837,0.043052838,0.34915199,0.059197652
Obuasi East,8007,1703,1407,723,980,427,5877,227,3643,237,0.212688897,0.175721244,0.090295991,0.122392906,0.053328338,0.733982765,0.028350194,0.454976895,0.029599101
Obuasi Municipal,9108,1603,1319,725,878,441,7064,294,4878,259,0.175999122,0.144817743,0.079600351,0.09639877,0.048418972,0.775581906,0.032279315,0.535573123,0.028436539
Adansi North,4675,1162,1096,387,775,321,3192,153,2404,220,0.24855615,0.234438503,0.082780749,0.165775401,0.068663102,0.682780749,0.032727273,0.514224599,0.047058824
Bekwai Municipal,11855,2861,2801,898,1963,838,8156,423,6573,696,0.241332771,0.236271615,0.075748629,0.165584142,0.070687474,0.687979755,0.035681147,0.554449599,0.058709405
Amansie West,9510,3488,3067,997,2491,576,5446,415,3655,452,0.366771819,0.322502629,0.104837014,0.261934805,0.060567823,0.572660358,0.043638275,0.384332282,0.047528917
Atwima Kwanwoma,19953,3943,3428,1721,2222,1206,14804,756,10387,874,0.197614394,0.171803739,0.086252694,0.1113617,0.060442039,0.741943567,0.037889039,0.520573347,0.043802937
Bosomtwi,14082,2788,2603,1173,1615,988,10306,482,8016,755,0.197983241,0.184845903,0.083297827,0.114685414,0.070160489,0.73185627,0.034228093,0.569237324,0.053614543
Bosome Freho,5296,2109,2074,549,1560,514,2673,323,2009,418,0.398225076,0.391616314,0.103663142,0.294561934,0.097054381,0.504720544,0.060989426,0.3793429,0.078927492
Asante Akim Central Municipal,7825,1828,1740,670,1158,582,5415,267,4248,451,0.233610224,0.222364217,0.085623003,0.14798722,0.074376997,0.69201278,0.034121406,0.542875399,0.057635783
Asante Akim South Municipal,10476,3677,3290,1195,2482,808,5991,593,4209,634,0.350992745,0.314051165,0.114070256,0.236922489,0.077128675,0.57187858,0.056605575,0.401775487,0.060519282
Asante Akim North Municipal,7300,2313,2231,622,1691,540,4447,276,3323,389,0.316849315,0.305616438,0.085205479,0.231643836,0.073972603,0.609178082,0.037808219,0.455205479,0.053287671
Sekyere Kumawu,5486,1576,1514,499,1077,437,3473,251,2777,368,0.287276704,0.27597521,0.090958804,0.1963179,0.07965731,0.633065986,0.045752825,0.506197594,0.06707984
Sekyere East,6367,1626,1396,637,989,407,4334,313,3222,345,0.2553793,0.219255536,0.100047118,0.155332182,0.063923355,0.680697346,0.04915973,0.506046804,0.054185645
Juaben Municipal,5466,1595,1602,471,1124,478,3393,180,2389,375,0.291803879,0.293084523,0.086169045,0.205634834,0.087449689,0.620746432,0.032930845,0.437065496,0.068605928
Ejisu Municipal,15540,3244,2782,1375,1869,913,11383,582,8020,622,0.208751609,0.179021879,0.088481338,0.12027027,0.058751609,0.732496782,0.037451737,0.516087516,0.04002574
Oforikrom Municipal,19102,2569,2154,1208,1361,793,15740,391,11786,475,0.134488535,0.112763061,0.063239451,0.071249084,0.041513978,0.823997487,0.020469061,0.617003455,0.024866506
Asokwa Municipal,10923,1713,1372,805,908,464,8746,276,5948,288,0.156825048,0.125606518,0.073697702,0.083127346,0.042479172,0.80069578,0.025267784,0.544539046,0.026366383
Kumasi Metropolitan Area (KMA),39062,5588,4723,2848,2740,1983,31491,888,23464,1382,0.143054631,0.120910348,0.072909733,0.070144898,0.05076545,0.806179919,0.022733091,0.600686089,0.035379653
Kwadaso Municipal,13566,1824,1396,997,827,569,11173,518,8821,438,0.134453782,0.10290432,0.073492555,0.060961227,0.041943093,0.823603125,0.038183695,0.650228512,0.032286599
Suame Municipal,11799,1787,1524,874,913,611,9401,329,6798,398,0.151453513,0.129163488,0.074074074,0.077379439,0.051784049,0.796762437,0.027883719,0.576150521,0.033731672
Old Tafo Municipal,9967,1680,1436,805,875,561,7726,289,5726,372,0.168556236,0.144075449,0.08076653,0.087789706,0.056285743,0.775158021,0.028995686,0.574495836,0.037323166
Asokore Mampong Municipal,16542,4290,3098,2222,2068,1030,11222,592,6870,560,0.259339862,0.187280861,0.134324749,0.125015113,0.062265748,0.67839439,0.035787692,0.415306493,0.033853222
Kwabre East,25098,4636,4131,2129,2507,1624,18838,851,14375,1207,0.184715914,0.164594788,0.084827476,0.099888437,0.064706351,0.750577735,0.033907084,0.572754801,0.048091481
Afigya Kwabre South,19843,3829,3361,1782,2047,1314,14700,654,11227,966,0.192964773,0.16937963,0.089804969,0.103159804,0.066219826,0.740815401,0.032958726,0.565791463,0.048682155
Atwima Nwabiagya North,13231,2743,2484,1067,1676,808,9680,373,7150,593,0.207316151,0.187740911,0.080643942,0.126672209,0.061068702,0.731615146,0.028191369,0.540397551,0.044818986
Atwima Nwabiagya South Municipal,13875,2628,2490,1024,1604,886,10361,346,7621,597,0.189405405,0.179459459,0.073801802,0.115603604,0.063855856,0.746738739,0.024936937,0.549261261,0.043027027
Atwima Mponua,12981,5064,4952,1316,3748,1204,6713,623,4681,926,0.39010862,0.381480626,0.101378938,0.288729682,0.092750944,0.517140436,0.047993221,0.36060396,0.071335028
Ahafo Ano South West,5596,2327,2249,540,1787,462,2807,192,1695,319,0.415832738,0.40189421,0.096497498,0.319335239,0.082558971,0.501608292,0.034310222,0.302894925,0.057005004
Ahafo Ano North Municipal,7876,2645,2642,599,2046,596,4635,293,3494,460,0.335830371,0.335449467,0.076053834,0.259776536,0.07567293,0.588496699,0.037201625,0.443626206,0.058405282
Ahafo Ano South East,5348,2241,2107,529,1712,395,2712,202,1737,280,0.419035153,0.393979058,0.098915482,0.320119671,0.073859387,0.50710546,0.037771129,0.324794316,0.052356021
Offinso North,6994,3264,3240,537,2727,513,3217,140,2140,345,0.466685731,0.463254218,0.076780097,0.389905633,0.073348585,0.459965685,0.020017158,0.305976551,0.049327995
Offinso Municipal,11649,3744,3685,984,2760,925,6980,307,5122,653,0.321400979,0.316336166,0.08447077,0.236930209,0.079405958,0.599193064,0.026354193,0.439694394,0.056056314
Afigya Kwabre North,6138,1903,1666,691,1212,454,3781,205,2711,350,0.310035842,0.271423917,0.112577387,0.197458456,0.073965461,0.615998697,0.033398501,0.441674813,0.057021831
Sekyere South,10196,2407,2358,762,1645,713,7076,284,5756,532,0.23607297,0.231267164,0.07473519,0.16133778,0.069929384,0.693997646,0.02785406,0.564535112,0.052177324
Mampong Municipal,9995,2685,2669,736,1949,720,6590,319,5331,606,0.268634317,0.267033517,0.073636818,0.194997499,0.072036018,0.659329665,0.031915958,0.533366683,0.060630315
Ejura Sekyedumase Municipal,11419,5177,4662,1366,3811,851,5391,228,2809,428,0.453367195,0.408266924,0.119625186,0.333742009,0.074524915,0.47210789,0.019966722,0.24599352,0.037481391
Sekyere Central,6128,2564,2529,484,2080,449,3115,202,2441,344,0.418407311,0.412695822,0.078981723,0.339425587,0.073270235,0.508322454,0.032963446,0.398335509,0.05613577
Sekyere Afram Plains,2670,1748,1722,234,1514,208,714,45,423,111,0.654681648,0.64494382,0.087640449,0.567041199,0.077902622,0.26741573,0.016853933,0.158426966,0.041573034
Aowin Municipal,11290,5471,5103,1155,4316,787,5032,334,2583,400,0.484588131,0.451992914,0.102302923,0.382285208,0.069707706,0.445704163,0.029583702,0.228786537,0.035429584
Sefwi Akontombra,5662,2416,2455,469,1947,508,2738,123,1570,259,0.426704345,0.43359237,0.082832921,0.343871424,0.089720947,0.483574709,0.021723773,0.277287178,0.045743554
Suaman,3307,1310,1192,366,944,248,1749,61,1179,146,0.396129422,0.360447536,0.110674327,0.285455095,0.07499244,0.528878137,0.018445721,0.35651648,0.044148775
Bodi,5641,2417,2265,533,1884,381,2843,117,1644,209,0.428470129,0.401524552,0.094486793,0.333983336,0.067541216,0.503988654,0.020741003,0.291437688,0.037050168
Sefwi Wiawso Municipal,13066,4257,4020,1238,3019,1001,7808,322,4898,622,0.325807439,0.307668759,0.094749732,0.231057707,0.076611052,0.597581509,0.024644114,0.374866065,0.04760447
Bibiani Anhwiaso Bekwai Municipal,14332,4300,3971,1193,3107,864,9168,354,5526,502,0.30002791,0.277072286,0.083240301,0.216787608,0.060284678,0.639687413,0.024699972,0.385570751,0.035026514
Juaboso,7582,3169,2880,746,2423,457,3956,186,2126,259,0.417963598,0.379847006,0.098390926,0.319572672,0.060274334,0.521762068,0.024531786,0.28040095,0.034159852
Bia West,9707,4475,4139,1031,3444,695,4537,236,2631,349,0.46100752,0.426393324,0.106212012,0.354795508,0.071597816,0.467394664,0.024312352,0.271041516,0.035953436
Bia East,4463,2052,1927,528,1524,403,2008,113,1184,214,0.459780417,0.43177235,0.118306072,0.341474345,0.090298006,0.449921577,0.025319292,0.265292404,0.04794981
Asunafo South,7794,2957,2633,914,2043,590,4247,300,2834,431,0.379394406,0.337823967,0.117269695,0.262124711,0.075699256,0.544906338,0.038491147,0.363613036,0.055298948
Asunafo North Municipal,12855,4551,4022,1377,3174,848,7456,535,5388,666,0.354025671,0.312874368,0.107117853,0.246907818,0.06596655,0.580007779,0.041618047,0.419136523,0.051808635
Asutifi South,5753,2158,1869,705,1453,416,3179,212,2295,258,0.375108639,0.324873979,0.122544759,0.25256388,0.072310099,0.552581262,0.036850339,0.398922301,0.044846167
Asutifi North,6299,2026,1915,534,1492,423,3850,141,2511,262,0.321638355,0.304016511,0.084775361,0.236862994,0.067153516,0.611208128,0.022384505,0.398634704,0.041593904
Tano North Municipal,8055,2501,2438,770,1731,707,4847,267,3378,523,0.310490379,0.30266915,0.0955928,0.214897579,0.08777157,0.601738051,0.033147114,0.419366853,0.064928616
Tano South Municipal,7426,2625,2427,746,1879,548,4253,239,2898,385,0.353487746,0.32682467,0.100457851,0.253029895,0.073794775,0.572717479,0.032184218,0.390250471,0.051844869
Dormaa West,4022,1574,1384,490,1084,300,2148,174,1648,249,0.391347588,0.344107409,0.121829935,0.269517653,0.074589756,0.534062655,0.043262059,0.409746395,0.061909498
Dormaa Central Municipal,9718,2909,2633,943,1966,667,6142,352,4780,540,0.299341428,0.270940523,0.097036427,0.202305001,0.068635522,0.63202305,0.036221445,0.491870755,0.055566989
Dormaa East,5938,1817,1739,505,1312,427,3694,129,2835,328,0.305995285,0.292859549,0.08504547,0.220949815,0.071909734,0.622094981,0.021724486,0.477433479,0.055237454
Sunyani Municipal,16808,3328,2941,1380,1948,993,12487,508,8932,612,0.198000952,0.174976202,0.08210376,0.115897192,0.05907901,0.742920038,0.030223703,0.531413613,0.036411233
Sunyani West Municipal,11755,3104,2978,970,2134,844,7807,226,5397,597,0.264057848,0.253339005,0.082518077,0.18153977,0.071799234,0.664142918,0.019225861,0.459123777,0.050786899
Berekum East Municipal,9341,1914,1774,773,1141,633,6794,278,5400,482,0.204903115,0.189915427,0.082753453,0.122149663,0.067765764,0.727331121,0.029761268,0.578096564,0.051600471
Berekum West,4285,1257,1163,423,834,329,2699,108,2033,247,0.293348891,0.271411902,0.098716453,0.194632439,0.076779463,0.629871645,0.025204201,0.474445741,0.05764294
Jaman South,9392,3193,2975,965,2228,747,5452,320,4022,539,0.339970187,0.316758944,0.102747019,0.237223169,0.079535775,0.580494037,0.03407155,0.428236797,0.057389267
Jaman North,9889,3211,3147,902,2309,838,5840,154,4268,613,0.324704217,0.318232379,0.091212458,0.233491759,0.084740621,0.590555162,0.015572859,0.431590656,0.061988068
Tain,9776,4413,4290,767,3646,644,4719,183,3046,378,0.45141162,0.438829787,0.078457447,0.372954173,0.065875614,0.482712766,0.018719313,0.311579378,0.038666121
Wenchi Municipal,10501,4392,3858,1117,3275,583,5526,156,3260,296,0.418245881,0.367393582,0.106370822,0.31187506,0.055518522,0.526235597,0.014855728,0.310446624,0.028187792
Banda,2395,1243,1167,236,1007,160,992,46,509,69,0.518997912,0.487265136,0.098538622,0.42045929,0.066805846,0.414196242,0.019206681,0.212526096,0.028810021
Nkoranza South Municipal,9677,3783,3481,1023,2760,721,5173,300,3404,484,0.39092694,0.359718921,0.105714581,0.285212359,0.074506562,0.534566498,0.031001343,0.35176191,0.050015501
Techiman Municipal,20626,6336,5525,2202,4134,1391,12899,452,8131,794,0.307185106,0.2678658,0.10675846,0.200426646,0.067439154,0.625375739,0.021914089,0.39421119,0.038495103
Nkoranza North,4778,2073,2049,417,1656,393,2312,92,1635,289,0.433863541,0.428840519,0.08727501,0.346588531,0.082251988,0.48388447,0.019254918,0.342193386,0.060485559
Techiman North,8644,2858,2568,878,1980,588,5198,167,3340,372,0.330633966,0.297084683,0.101573346,0.22906062,0.068024063,0.601341971,0.019319759,0.386395187,0.043035632
Atebubu Amantin Municipal,11862,6162,5937,1114,5048,889,4811,108,2178,358,0.51947395,0.500505817,0.093913337,0.425560614,0.074945203,0.405580846,0.009104704,0.183611533,0.030180408
Sene West,5783,3319,3157,531,2788,369,2095,85,985,149,0.573923569,0.545910427,0.091820854,0.482102715,0.063807712,0.362268719,0.014698254,0.17032682,0.025765174
Sene East,5795,3620,3434,549,3071,363,1812,64,674,101,0.624676445,0.59257981,0.094736842,0.529939603,0.062640207,0.312683348,0.011044003,0.116307161,0.017428818
Pru West,5813,3421,3318,516,2905,413,1979,85,1001,163,0.588508515,0.570789609,0.088766558,0.499741958,0.071047652,0.340443833,0.014622398,0.172200241,0.028040599
Pru East,8317,4542,4395,808,3734,661,3114,102,1077,156,0.546110376,0.528435734,0.097150415,0.448959962,0.079475773,0.374413851,0.012264038,0.129493808,0.018756763
Kintampo South,7356,3660,3685,561,3099,586,3110,125,1664,289,0.497553018,0.500951604,0.076264274,0.421288744,0.07966286,0.422784122,0.016992931,0.226209897,0.039287656
Kintampo North Municipal,11658,5861,5712,965,4896,816,4981,117,2187,241,0.502744896,0.489963973,0.082775776,0.41996912,0.069994853,0.42726025,0.010036027,0.1875965,0.0206725
Biakoye,6082,2570,2434,597,1973,461,3051,294,1675,170,0.422558369,0.400197304,0.0981585,0.324399868,0.075797435,0.501644196,0.048339362,0.275402828,0.027951332
Jasikan Municipal,5121,1718,1586,504,1214,372,3031,305,1803,157,0.335481351,0.309705136,0.098418278,0.237063074,0.072642062,0.591876587,0.05955868,0.352079672,0.030658075
Kadjebi,6189,2530,2192,775,1755,437,3222,378,1751,157,0.408789788,0.354176765,0.125222168,0.28356762,0.070609145,0.520601066,0.061076103,0.282921312,0.025367588
Krachi East Municipal,9014,5031,4934,787,4244,690,3293,146,1342,135,0.558131795,0.547370757,0.087308631,0.470823164,0.076547593,0.365320612,0.016197027,0.148879521,0.014976703
Krachi West Municipal,5226,2637,2560,506,2131,429,2160,62,928,144,0.504592423,0.4898584,0.096823574,0.407768848,0.082089552,0.413318025,0.011863758,0.17757367,0.027554535
Krachi Nchumuru,6531,3945,4027,457,3488,539,2047,65,695,125,0.60404226,0.616597765,0.06997397,0.53406829,0.082529475,0.313428265,0.009952534,0.106415557,0.019139489
Nkwanta South Municipal,11114,6201,6281,822,5379,902,4011,162,1420,179,0.557944934,0.565143063,0.07396077,0.483984164,0.081158899,0.360896167,0.01457621,0.127766781,0.016105812
Nkwanta North (Kpassa),9915,6996,6693,958,6038,655,2264,75,431,60,0.705597579,0.675037821,0.096621281,0.608976299,0.066061523,0.228340898,0.007564297,0.043469491,0.006051437
Guan,2489,671,644,246,425,219,1599,179,1008,113,0.269586179,0.258738449,0.098834873,0.170751306,0.087987143,0.642426677,0.071916432,0.40498192,0.045399759
Kpandai,10135,6500,6431,859,5641,790,2845,64,382,66,0.641341885,0.634533794,0.084755797,0.556586088,0.077947706,0.280710409,0.006314751,0.037691169,0.006512087
Nanumba South,8133,5864,5604,674,5190,414,1855,42,636,99,0.721013156,0.689044633,0.082872249,0.638140907,0.050903726,0.228083118,0.005164146,0.078199926,0.01217263
Nanumba North Municipal,14833,10128,9678,1234,8894,784,3921,79,1793,229,0.682801861,0.6524641,0.083192881,0.59960898,0.05285512,0.264343019,0.005325962,0.120879121,0.015438549
Zabzugu,6334,4606,4317,567,4039,278,1450,43,573,81,0.727186612,0.681559836,0.089516893,0.637669719,0.043890117,0.228923271,0.006788759,0.090464162,0.012788128
Tatale Sanguli,5861,4130,3975,478,3652,323,1408,23,127,6,0.704657908,0.678211909,0.081556048,0.62310186,0.055110049,0.240232042,0.003924245,0.021668657,0.001023716
Saboba,7802,4355,4787,471,3884,903,2544,75,391,38,0.558190208,0.613560625,0.060369136,0.497821072,0.115739554,0.326070238,0.00961292,0.050115355,0.004870546
Yendi Municipal,12438,7198,6793,1172,6026,767,4473,146,2677,390,0.578710404,0.546148899,0.094227368,0.484483036,0.061665863,0.359623734,0.011738222,0.215227529,0.031355523
Mion,7421,5885,5663,604,5281,382,1154,60,500,113,0.793019809,0.763104703,0.081390648,0.71162916,0.051475542,0.155504649,0.008085164,0.067376364,0.015227058
Nanton,3903,2905,2707,413,2492,215,783,46,537,138,0.744299257,0.693569049,0.105816039,0.638483218,0.055085831,0.200614912,0.011785806,0.137586472,0.035357417
Tamale Metropolitan Area (TMA),30556,12560,11775,3127,9433,2342,15654,390,8970,1060,0.411048567,0.385358031,0.102336693,0.308711873,0.076646158,0.512305276,0.012763451,0.293559366,0.034690405
Sagnarigu Municipal,27922,9760,9471,2396,7364,2107,16055,367,9105,1026,0.349545162,0.3391949,0.085810472,0.263734689,0.075460211,0.574994628,0.013143758,0.326086957,0.036745219
Tolon,9209,6774,6257,971,5803,454,1981,132,1377,320,0.735584754,0.679444022,0.10544033,0.630144424,0.049299598,0.215115648,0.014333804,0.149527636,0.034748615
Kumbungu,8470,5804,5350,948,4856,494,2172,168,1589,338,0.685242031,0.631641086,0.111924439,0.573317591,0.058323495,0.256434475,0.019834711,0.187603306,0.039905549
Savelugu Municipal,9735,6186,5730,1054,5132,598,2951,94,1878,385,0.635439137,0.588597843,0.108269132,0.527170005,0.061427838,0.303133025,0.009655881,0.192912173,0.039548023
Karaga,8597,7013,6507,824,6189,318,1266,114,699,177,0.81574968,0.756891939,0.095847389,0.719902291,0.036989648,0.147260672,0.01326044,0.081307433,0.020588577
Gushegu Municipal,11369,9175,8478,985,8190,288,1906,92,1131,161,0.807019087,0.745712024,0.086639106,0.720379981,0.025332043,0.16764887,0.00809218,0.099481045,0.014161316
Bole,9533,5772,5213,1130,4642,571,3190,115,972,114,0.605475716,0.546837302,0.118535613,0.486940103,0.059897199,0.334627085,0.012063359,0.101961607,0.01195846
Sawla Tuna Kalba,9146,6559,6498,534,6025,473,2114,62,519,61,0.717144107,0.710474524,0.05838618,0.658757927,0.051716597,0.231139296,0.00677892,0.056746119,0.006669582
North Gonja,4759,3665,3483,403,3262,221,873,30,307,37,0.770119773,0.731876445,0.084681656,0.685438117,0.046438327,0.1834419,0.006303845,0.064509351,0.007774743
West Gonja,5245,2637,2573,455,2182,391,2217,52,1060,144,0.502764538,0.49056244,0.086749285,0.416015253,0.074547188,0.422688275,0.009914204,0.202097235,0.027454719
Central Gonja,10913,8269,7743,942,7327,416,2228,89,977,162,0.75772015,0.709520755,0.086319069,0.671401081,0.038119674,0.204160176,0.008155411,0.089526253,0.014844681
East Gonja Municipal,9490,6020,5550,985,5035,515,2955,83,882,109,0.634351949,0.584826133,0.103793467,0.530558483,0.05426765,0.3113804,0.008746048,0.092939937,0.011485774
North East Gonja,2961,2352,2251,233,2119,132,477,29,201,57,0.794326241,0.760216143,0.078689632,0.715636609,0.044579534,0.161094225,0.009793989,0.067882472,0.019250253
Mamprugu Moagduri,5256,4122,3871,488,3634,237,897,38,277,45,0.784246575,0.736491629,0.092846271,0.691400304,0.045091324,0.1706621,0.007229833,0.052701674,0.008561644
West Mamprusi Municipal,13954,8283,7627,1583,6700,927,4744,132,1387,178,0.593593235,0.546581625,0.113444174,0.480149061,0.066432564,0.339974201,0.009459653,0.099398022,0.012756199
East Mamprusi Municipal,14815,9908,9139,1516,8392,747,4160,186,1287,162,0.66878164,0.616874789,0.102328721,0.566452919,0.05042187,0.28079649,0.012554843,0.086871414,0.010934863
Bunkpurugu Nakpanduri,6926,3246,3217,522,2724,493,3187,45,263,18,0.468668784,0.464481663,0.075368178,0.393300606,0.071181057,0.460150159,0.006497257,0.037972856,0.002598903
Yunyoo Nasuan,4442,3283,3102,408,2875,227,932,17,122,12,0.739081495,0.698334084,0.091850518,0.647230977,0.051103107,0.209815398,0.003827105,0.027465106,0.002701486
Chereponi,6726,4912,4701,605,4307,394,1420,44,140,12,0.730300327,0.698929527,0.08994945,0.640350877,0.05857865,0.211121023,0.006541778,0.020814749,0.001784121
Builsa South,3090,1860,1900,224,1636,264,966,10,101,8,0.601941748,0.614886731,0.072491909,0.529449838,0.085436893,0.312621359,0.003236246,0.032686084,0.002588997
Builsa North Municipal,4773,2300,2482,242,2058,424,2049,18,306,13,0.481877226,0.52000838,0.050701865,0.431175361,0.088833019,0.429289755,0.003771213,0.064110622,0.002723654
Kasena Nankana Municipal,8606,3360,3482,508,2852,630,4616,67,1971,132,0.390425285,0.404601441,0.059028585,0.3313967,0.073204741,0.536369974,0.007785266,0.229026261,0.015338136
Kasena Nankana West,7673,3795,3725,720,3075,650,3228,86,1357,241,0.494591424,0.485468526,0.093835527,0.400755897,0.084712629,0.420695947,0.011208132,0.176853903,0.031408836
Bolgatanga Municipal,12063,4071,4132,717,3354,778,7214,81,1344,92,0.337478239,0.342535024,0.059437951,0.278040288,0.064494736,0.598027025,0.006714748,0.111415071,0.007626627
Talensi,7374,3578,3790,576,3002,788,3008,12,290,26,0.485218335,0.513967996,0.078112286,0.407106048,0.106861947,0.407919718,0.001627339,0.039327366,0.003525902
Bolgatanga East,3290,1269,1159,372,897,262,1759,8,262,25,0.385714286,0.352279635,0.113069909,0.272644377,0.079635258,0.534650456,0.002431611,0.079635258,0.007598784
Bongo,9808,5260,5194,868,4392,802,3746,57,715,120,0.5362969,0.5295677,0.088499184,0.447797716,0.081769984,0.381933116,0.005811582,0.072899674,0.01223491
Nabdam,4564,2493,2451,418,2075,376,1695,15,190,11,0.546231376,0.537028922,0.091586328,0.454645048,0.082383874,0.37138475,0.003286591,0.041630149,0.002410167
Bawku West,12062,7585,7466,1028,6557,909,3568,46,288,26,0.628834356,0.618968662,0.085226331,0.543608025,0.075360637,0.295805007,0.00381363,0.023876637,0.00215553
Binduri,6502,4052,4172,394,3658,514,1936,20,208,20,0.623192864,0.641648723,0.060596739,0.562596124,0.079052599,0.297754537,0.003075977,0.031990157,0.003075977
Bawku Municipal,10052,5132,4790,1121,4011,779,4141,138,502,81,0.510545165,0.476522085,0.111520096,0.39902507,0.077497016,0.411957819,0.013728611,0.04994031,0.008058098
Garu,6017,3726,3795,417,3309,486,1805,8,95,7,0.619245471,0.63071298,0.06930364,0.549941831,0.080771148,0.29998338,0.001329566,0.015788599,0.00116337
Tempane,7236,4860,4780,632,4228,552,1824,29,155,25,0.671641791,0.660585959,0.087341072,0.584300719,0.07628524,0.252072968,0.004007739,0.021420674,0.003454947
Pusiga,6563,4483,3812,1083,3400,412,1668,37,91,15,0.683071766,0.580831937,0.165015999,0.518055767,0.062776169,0.254152065,0.005637666,0.01386561,0.00228554
Wa West,8086,5503,5572,585,4918,654,1929,80,875,258,0.680558991,0.689092258,0.072347267,0.608211724,0.080880534,0.238560475,0.009893643,0.108211724,0.031907
Wa East,7478,5410,5249,594,4816,433,1635,86,515,112,0.723455469,0.701925649,0.079433003,0.644022466,0.057903183,0.218641348,0.011500401,0.068868681,0.014977267
Wa Municipal,16878,5562,5544,1425,4137,1407,9909,179,4475,480,0.329541415,0.328474938,0.084429435,0.24511198,0.083362958,0.587095627,0.010605522,0.26513805,0.028439389
Nadowli Kaleo,6482,3434,3625,424,3010,615,2433,46,1454,306,0.529774761,0.559240975,0.06541191,0.464362851,0.094878124,0.375347115,0.007096575,0.224313483,0.047207652
Daffiama Bussie Issa,3237,2173,2123,244,1929,194,870,16,469,106,0.671300587,0.655854186,0.075378437,0.59592215,0.059932036,0.268767377,0.004942848,0.144887241,0.03274637
Sissala East Municipal,6559,3733,3484,719,3014,470,2356,37,234,17,0.569141637,0.531178533,0.109620369,0.459521268,0.071657265,0.359201098,0.005641104,0.03567617,0.002591859
Sissala West,5203,3260,3129,523,2737,392,1551,30,206,37,0.626561599,0.601383817,0.100518931,0.526042668,0.075341149,0.298097252,0.005765904,0.039592543,0.007111282
Jirapa Municipal,7798,4459,4571,576,3883,688,2651,49,1593,381,0.571813285,0.586175943,0.073865094,0.497948192,0.088227751,0.339958964,0.006283662,0.20428315,0.048858682
Lawra Municipal,4963,2732,2687,422,2310,377,1854,45,1074,198,0.550473504,0.541406407,0.085029216,0.465444288,0.07596212,0.373564376,0.009067097,0.21640137,0.039895225
Lambussie Karni,4267,2517,2642,318,2199,443,1307,23,401,100,0.589875791,0.619170377,0.074525428,0.515350363,0.103820014,0.306304195,0.005390204,0.093977033,0.023435669
Nandom,4363,2230,2377,213,2017,360,1773,17,919,185,0.511116204,0.544808618,0.04881962,0.462296585,0.082512033,0.406371763,0.003896402,0.210634884,0.042402017
